NO ./textures/no.xpm
SO ./textures/so.xpm
WE ./textures/we.xpm
EA ./textures/ea.xpm

F 101,67,33
C 135,206,235

1111111111111111111111111
1000000010001000100000001
1011111010101010101111101
1010000000101000000000101
1010111111101011111110101
1010100000001000000010101
1011101011111111101010101
1000101010000000101010101
1110101010111110101010101
1000100010001000100010101
1011111111101011111110101
1010000000001000000000101
1010111111111111111111101
1010001000001000000000001
1011101011101010111111111
1000100010100010100000001
1110111010111110101111101
1000100010001000101000101
1011101110111011101010101
1010001000100000101010101
1010111011101110101010101
1010100010001000100010101
1010101111111011111110101
100010000N000000000000001
1111111111111111111111111