NO ./textures/no.xpm
SO ./textures/so.xpm
WE ./textures/we.xpm
EA ./textures/ea.xpm

F 101,67,33
C 135,206,235

1111111111
1W00000001
1000000001
1000000001
10000000                         01
1111111111